1 &2 &3 &4 &5 &6 &7 &8 &\\
1 & *& 2& 0& 0& 2& *& 2& 0& \\
2 & *& *& 1& 1& *& 3& *& 2& \\
3 & 2& *& 1& 1& 2& 2& *& *& \\
4 & 1& 1& 1& *& *& *& *& 2& \\
5 & *& 2& 2& *& 3& *& *& 2& \\
6 & *& *& *& *& 1& 3& *& *& \\
7 & *& 3& 2& *& 2& *& *& 2& \\
8 & *& *& 1& 1& 0& 2& *& 1& \\
